#http://www.myrsten.nu/worldnet/beatlesongs.htm

Album: Please Please Me 1963
Song 	Main composer 	Singer
Love Me Do 	McCartney 	Lennon/McCartney
P.S. I Love You 	McCartney 	McCartney
Please Please Me 	Lennon 	Lennon/McCartney
Ask Me Why 	Lennon 	Lennon
There´s a Place 	Lennon 	Lennon
I Saw Her Standing There 	McCartney 	McCartney
Do You Want to Know a Secret 	Lennon 	Harrison
Misery 	Lennon/McCartney 	Lennon/McCartney
A Taste of Honey 	Scott/Marlow 	McCartney
Anna (Go to Him) 	Alexander 	Lennon
Boys 	Dixon/Farrell 	Starr
Chains 	Goffin/King 	Harrison
Baby It´s You 	David/Williams/Bacharach 	Lennon
Twist and Shout 	Medley/Russel 	Lennon


Album: With The Beatles 1963
Song 	Main composer 	Singer
Hold Me Tight 	McCartney 	McCartney
It Won´t Be Long 	Lennon 	Lennon
All My Loving 	McCartney  	McCartney
I Wanna Be Your Man 	Lennon/McCartney 	Starr
Little Child 	Lennon/McCartney 	Lennon/McCartney
All I´ve Got to Do 	Lennon 	Lennon
Not a Second Time 	Lennon 	Lennon
Don´t Bother Me 	Harrison 	Harrison
Roll Over Beethoven 	Berry 	Harrison
You Really Got a Hold on Me  	Robinson 	Lennon/Harrison
Money (That´s What I Want) 	Bradford/Gordy 	Lennon
Devil in Her Heart 	Drapkin 	Harrison
Till There Was You 	Wilson 	McCartney
Please Mr Postman 	Holland/Bateman/Garrett/Dobbins/Gorman 	Lennon

	
	
Album: Long Tall Sally 1964
Song 	Main composer 	Singer
Album: Long Tall Sally 	Johnson/Penniman/Blackwell 	McCartney
I Call Your Name 	Lennon 	Lennon
Matchbox 	Perkins 	Starr
Slow Down 	Williams 	Lennon



Album: A Hard Day's Night 1964
Song 	Main composer 	Singer
Can´t Buy Me Love 	McCartney 	McCartney
You Can´t Do That 	Lennon 	Lennon
And I Love Her 	McCartney 	McCartney
I Should Have Known Better 	Lennon 	Lennon
Tell Me Why  	Lennon 	Lennon
If I fell 	Lennon 	Lennon/McCartney
I´m Happy Just to Dance With You 	Lennon 	Harrison
A Hard Day´s Night 	Lennon 	Lennon/McCartney
I´ll Cry Instead 	Lennon 	Lennon
I´ll Be Back 	Lennon 	Lennon
Any Time at All 	Lennon 	Lennon
Things We Said Today 	McCartney 	McCartney
When I Get Home 	Lennon 	Lennon

	
	
Album: Beatles For Sale 1964
Song 	Main composer 	Singer
Baby´s in Black 	Lennon/McCartney 	Lennon/McCartney
I´m a Loser 	Lennon 	Lennon
Every Little Thing 	McCartney 	Lennon
I Don´t Want to Spoil the Party 	Lennon 	Lennon/Harrison
What You´re Doing 	McCartney 	McCartney
No Reply 	Lennon 	Lennon
Eight Days a Week 	McCartney 	Lennon/McCartney
I´ll Follow the Sun 	McCartney 	McCartney
Mr Moonlight 	Johnson 	Lennon
Kansas City/Hey, Hey, Hey, Hey 	Leiber/Stoller/Penniman 	McCartney
Everybody´s Trying to Be My Baby 	Perkins 	Harrison
Rock and Roll Music 	Berry 	Lennon
Words of Love 	Holly 	Lennon/McCartney
Honey Don´t 	Perkins 	Starr

	
	
Album: Help! 1965
Song 	Main composer 	Singer
Ticket to Ride 	Lennon 	Lennon
Another Girl 	McCartney 	McCartney
I Need You 	Harrison 	Harrison
The Night Before 	McCartney 	McCartney
You Like Me Too Much 	Harrison 	Harrison
You´ve Got to Hide Your Love Away 	Lennon 	Lennon
Tell Me What You See 	McCartney 	McCartney
You´re Going to Lose That Girl 	Lennon 	Lennon
Help! 	Lennon 	Lennon
I´ve Just Seen a Face 	McCartney 	McCartney
Yesterday  	McCartney 	McCartney
It´s Only Love 	Lennon 	Lennon
Dizzy Miss Lizzy 	Williams 	Lennon
Act Naturally 	Morrison/Russel 	Starr
  	
	
Album: Rubber Soul 1965
Song 	Main composer 	Singer
Wait 	Lennon/McCartney 	Lennon/McCartney
Run for Your Life 	Lennon 	Lennon
Norwegian Wood (This Bird Has Flown) 	Lennon 	Lennon
Drive My Car 	McCartney 	Lennon/McCartney
If I Needed Someone  	Harrison 	Harrison
In My Life 	Lennon/McCartney 	Lennon
Nowhere Man 	Lennon 	Lennon
I´m Looking Through You 	McCartney 	McCartney
Michelle 	McCartney 	McCartney
What Goes On 	Lennon/McCartney 	Starr
Think for Yourself 	Harrison 	Harrison
The Word 	Lennon/McCartney 	Lennon/McCartney
You Won´t See Me 	McCartney 	McCartney
Girl 	Lennon 	Lennon

	
	
Album: Revolver 1966
Song 	Main composer 	Singer
Tomorrow Never Knows 	Lennon 	Lennon
Got to Get You Into My Life 	McCartney 	McCartney
Love You to 	Harrison 	Harrison
Doctor Robert 	Lennon 	Lennon
And Your Bird Can Sing 	Lennon 	Lennon
Taxman 	Harrison 	Harrison
I´m Only Sleeping 	Lennon 	Lennon
Eleanor Rigby 	McCartney 	McCartney
For No One 	McCartney 	McCartney
Yellow Submarine 	McCartney 	Starr
I Want to Tell You 	Harrison 	Harrison
Good Day Sunshine  	McCartney 	McCartney
Here, There and Everywhere 	McCartney 	McCartney
She Said, She Said 	Lennon 	Lennon

	
	
Album: Sgt. Pepper's Lonely Hearts Club Band 1967
Song 	Main composer 	Singer
When I´m Sixty Four 	McCartney 	McCartney
A Day in the Life 	Lennon/McCartney 	Lennon/McCartney
Sgt. Pepper´s Lonely Hearts Club Band 	McCartney 	McCartney
Good Morning, Good Morning 	Lennon 	Lennon
Fixing a Hole 	McCartney 	McCartney
Being For the Benefit of Mr. Kite! 	Lennon 	Lennon
Lovely Rita 	McCartney 	McCartney
Lucy in the Sky with Diamonds 	Lennon 	Lennon
Getting Better 	McCartney 	McCartney
Within You Without You 	Harrison 	Harrison
She´s Leaving Home 	McCartney 	McCartney
With a Little Help From My Friends 	McCartney 	Starr
Sgt. Pepper´s Lonely Hearts Club Band (Reprise) 	McCartney 	Lennon/McCartney/Harrison/Starr

	
	
Album: Magical Mystery Tour 1967
Song 	Main composer 	Singer
Magical Mystery Tour 	McCartney 	McCartney
Your Mother Should Know 	McCartney 	McCartney
Blue Jay Way 	Harrison 	Harrison
Flying 	Harrison/Lennon/McCartney/Starkey 	Harrison/Lennon/McCartney/Starr
The Fool on the Hill 	McCartney 	McCartney
I Am the Walrus 	Lennon 	Lennon

	
	
Album: The Beatles 1968
Song 	Main composer 	Singer
Revolution 1 	Lennon 	Lennon
Don´t Pass Me By 	Starkey 	Starr
Revolution 9 	Lennon 	"Instrumental"
Blackbird 	McCartney 	McCartney
Everybody´s Got Something to Hide Except Me and My Monkey 	Lennon 	Lennon
Good Night 	Lennon 	Starr
Ob-la-di, Ob-la-da 	McCartney 	McCartney
Cry Baby Cry 	Lennon 	Lennon
Helter Skelter 	McCartney 	McCartney
Sexy Sadie 	Lennon 	Lennon
While My Guitar Gently Weeps 	Harrison 	Harrison
Mother Nature´s Son 	McCartney 	McCartney
Yer Blues 	Lennon 	Lennon
Rocky Raccoon 	McCartney 	McCartney
Wild Honey Pie 	McCartney 	McCartney
Back in the U.S.S.R. 	McCartney 	McCartney
Dear Prudence 	Lennon 	Lennon
Glass Onion 	Lennon 	Lennon
I Will 	McCartney 	McCartney
Birthday 	McCartney 	Lennon/McCartney
Piggies 	Harrison 	Harrison
Happiness is a Warm Gun 	Lennon 	Lennon
Honey Pie 	McCartney 	McCartney
Savoy Truffle 	Harrison 	Harrison
Martha My Dear 	McCartney 	McCartney
Long Long Long 	Harrison 	Harrison
I´m So Tired 	Lennon 	Lennon
The Continuing Story of Bungalow Bill 	Lennon 	Lennon
Why Don´t We Do It in the Road? 	McCartney 	McCartney
Julia 	Lennon 	Lennon

	
	
Album: Yellow Submarine 1969
Song 	Main composer 	Singer
Yellow Submarine 	McCartney 	Starr
Only a Nothern Song 	Harrison 	Harrison
All Together Now 	McCartney 	McCartney
It´s All Too Much 	Harrison 	Harrison
All You Need is Love 	Lennon 	Lennon
Hey Bulldog 	Lennon/McCartney 	Lennon



Album: Abbey Road 1969
Song 	Main composer 	Singer
I Want You (She´s So Heavy) 	Lennon 	Lennon
Something 	Harrison 	Harrison
Oh! Darling 	McCartney 	McCartney
Octopus´s Garden 	Starkey 	Starr
You Never Give Me Your Money 	McCartney 	McCartney
Her Majesty 	McCartney 	McCartney
Golden Slumbers 	McCartney 	McCartney
Carry That Weight 	McCartney 	McCartney
Here Comes the Sun 	Harrison 	Harrison
Maxwell´s Silver Hammer 	McCartney 	McCartney
Come Together 	Lennon 	Lennon
The End 	McCartney 	McCartney
Sun King 	Lennon 	Lennon
Mean Mr. Mustard 	Lennon 	Lennon
Polythene Pam 	Lennon 	Lennon
She Came in Through the Bathroom Window 	McCartney 	McCartney
Because 	Lennon 	Lennon/McCartney/Harrison

	
	
Album: Let It Be 1970
Song 	Main composer 	Singer
Across the Universe 	Lennon 	Lennon
Dig a Pony 	Lennon 	Lennon
I´ve Got a Feeling 	Lennon/McCartney 	Lennon/McCartney
Get Back 	McCartney 	McCartney
Two of Us 	McCartney 	Lennon/McCartney
Maggie Mae 	Trad. arr. 	Lennon/McCartney
Dig It 	Lennon 	Lennon
For You Blue 	Harrison 	Harrison
Let It Be 	McCartney 	McCartney
The Long and Winding Road 	McCartney 	McCartney
One After 909 	Lennon 	Lennon/McCartney
I Me Mine 	Harrison 	Harrison
